9 9
#########
#___#####
#_O_###.#
#_O_###.#
###_###.#
###_____#
##_O_#__#
##%__####
#########